    DDDDD                                                DDDDD
    DDDDD                                                DDDDD
    DDDDD                                                DDDDD
    DDDDD                                                DDDDD
    DDDDDDDDDDDDDDDDDDDD                                 DDDDD
    DDDDDDDDDDDDDDDDDDDD                                 DDDDD
    DDDDDDDDDDDDDDDDDDDD                                 DDDDD
    DDDDDDDDDDDDDDDDDDDD                                 DDDDD
    DDDDDDDDDDDDDDDDDDDD                                 DDDDD
                   DDDDD                                 DDDDD
                   DDDDD                                 DDDDD
                   DDDDD                                 DDDDD
                   DDDDD                                 DDDDD
                   DDDDDDDDDDDDDDDDDDDDDDDDDDDDDDDDDDDDDDDDDDDDDDDDD
                   DDDDDDDDDDDDDDDDDDDDDDDDDDDDDDDDDDDDDDDDDDDDDDDDD
                   DDDDDDDDDDDDDDDDDDDDDDDDDDDDDDDDDDDDDDDDDDDDDDDDD
                   DDDDDDDDDDDDDDDDDDDDDDDDDDDDDDDDDDDDDDDDDDDDDDDDD
                   DDDDDDDDDDDDDDDDDDDDDDDDDDDDDDDDDDDDDDDDDDDDDDDDD
                   DDDDDDDDDDDDDDDDDDDDDDDDDDDDDDDDDDDDDDDDDDDDDDDDD
                   DDDDD
                   DDDDD
                   DDDDD
                   DDDDD
                   DDDDD
