...........................................
...........................................
...........................................
...........................................
...........................................
...........................................
............###################............
............###################............
............########S##########............
............###################............
............###################............
...........................................
...........................................
...........................................
...........................................
...........................................
...........................................
